1111111111111111111111
10010000000010000001C1
1000011111001000000001
1P0011E1000111000CC101
10000000C0000000000011
1111111111111111111111