1111111111111
10010001000C1
1110011111001
11E011P000011
1111111111111