11111111111111111
100100000000001C1
10000111110000101
1P0011E00000CC101
10000000C00000001
11111111111111111