1111111111111111111111111111
1E0001C000000000000000000001
1111011000000000000000000001
1P00000000000000000000000001
1000000000000000000000000001
100C000000000000000000000001
1111111111111111111111111111